"filename", "language", "JavaScript", "CSS", "JavaScript JSX", "SCSS", "comment", "blank", "total"
"c:\Users\ketan\colon33\src\App.js", "JavaScript", 71, 0, 0, 0, 0, 0, 71
"c:\Users\ketan\colon33\src\components\ApplicationEngg\ApplicationEngg.jsx", "JavaScript JSX", 0, 0, 4, 0, 0, -6, -2
"c:\Users\ketan\colon33\src\components\CloudEngg\CloudEngg.jsx", "JavaScript JSX", 0, 0, 66, 0, 0, 3, 69
"c:\Users\ketan\colon33\src\components\CloudEngg\cloud.scss", "SCSS", 0, 0, 0, -2, 0, -3, -5
"c:\Users\ketan\colon33\src\components\CloudEngg\cloudengg.scss", "SCSS", 0, 0, 0, 8, 0, 2, 10
"c:\Users\ketan\colon33\src\components\Data&Analytics\Data&Analytics.jsx", "JavaScript JSX", 0, 0, 73, 0, 0, 7, 80
"c:\Users\ketan\colon33\src\components\Data&Analytics\data&analytics.scss", "SCSS", 0, 0, 0, 8, 0, 1, 9
"c:\Users\ketan\colon33\src\components\DigitalDefence\DigitalDefense.jsx", "JavaScript JSX", 0, 0, 73, 0, 0, 7, 80
"c:\Users\ketan\colon33\src\components\DigitalDefence\digitaldefense.scss", "SCSS", 0, 0, 0, 0, 0, 1, 1
"c:\Users\ketan\colon33\src\components\DigitalInnovation\DigitalInnovation.jsx", "JavaScript JSX", 0, 0, 85, 0, 0, 6, 91
"c:\Users\ketan\colon33\src\components\DigitalInnovation\digital-innovation.scss", "SCSS", 0, 0, 0, 8, 0, 4, 12
"c:\Users\ketan\colon33\src\components\EnterpriseApplications\Enterprise.jsx", "JavaScript JSX", 0, 0, 73, 0, 0, 7, 80
"c:\Users\ketan\colon33\src\components\EnterpriseApplications\enterprise.scss", "SCSS", 0, 0, 0, 8, 0, 0, 8
"c:\Users\ketan\colon33\src\components\Home\Home.jsx", "JavaScript JSX", 0, 0, 1, 0, 1, 0, 2
"c:\Users\ketan\colon33\src\components\Industries\Industries.jsx", "JavaScript JSX", 0, 0, 21, 0, 0, 2, 23
"c:\Users\ketan\colon33\src\components\Industries\industries.scss", "SCSS", 0, 0, 0, 8, 0, 1, 9
"c:\Users\ketan\colon33\src\components\InfrastructureServices\Infra.jsx", "JavaScript JSX", 0, 0, 61, 0, 0, 7, 68
"c:\Users\ketan\colon33\src\components\InfrastructureServices\infra.scss", "SCSS", 0, 0, 0, 8, 0, 0, 8
"c:\Users\ketan\colon33\src\components\LetsTalk\Letstalk.jsx", "JavaScript JSX", 0, 0, 0, 0, 0, -1, -1
"c:\Users\ketan\colon33\src\components\SubtoSubServices\AR\AR.jsx", "JavaScript JSX", 0, 0, 84, 0, 1, 5, 90
"c:\Users\ketan\colon33\src\components\SubtoSubServices\AR\ar.scss", "SCSS", 0, 0, 0, 8, 0, 0, 8
"c:\Users\ketan\colon33\src\components\SubtoSubServices\ApplicationSecurity\ApplicationSecurity.jsx", "JavaScript JSX", 0, 0, 72, 0, 1, 6, 79
"c:\Users\ketan\colon33\src\components\SubtoSubServices\ApplicationSecurity\app-security.scss", "SCSS", 0, 0, 0, 8, 0, 0, 8
"c:\Users\ketan\colon33\src\components\SubtoSubServices\CloudMigration\CloudMigration.jsx", "JavaScript JSX", 0, 0, 72, 0, 1, 6, 79
"c:\Users\ketan\colon33\src\components\SubtoSubServices\CloudMigration\cloudmigration.scss", "SCSS", 0, 0, 0, 8, 0, 0, 8
"c:\Users\ketan\colon33\src\components\SubtoSubServices\CloudOptimization\Cloudoptimization.jsx", "JavaScript JSX", 0, 0, 72, 0, 1, 6, 79
"c:\Users\ketan\colon33\src\components\SubtoSubServices\CloudOptimization\cloudoptimization.scss", "SCSS", 0, 0, 0, 8, 0, 0, 8
"c:\Users\ketan\colon33\src\components\SubtoSubServices\ConversationalAI\Conversationalai.jsx", "JavaScript JSX", 0, 0, 60, 0, 1, 6, 67
"c:\Users\ketan\colon33\src\components\SubtoSubServices\ConversationalAI\conversationalai.scss", "SCSS", 0, 0, 0, 8, 0, 0, 8
"c:\Users\ketan\colon33\src\components\SubtoSubServices\DCNetwork\DCNetwork.jsx", "JavaScript JSX", 0, 0, 60, 0, 1, 6, 67
"c:\Users\ketan\colon33\src\components\SubtoSubServices\DCNetwork\dcnetwork.scss", "SCSS", 0, 0, 0, 8, 0, 0, 8
"c:\Users\ketan\colon33\src\components\SubtoSubServices\DataAnalytics\DataAnalytics.jsx", "JavaScript JSX", 0, 0, 72, 0, 1, 6, 79
"c:\Users\ketan\colon33\src\components\SubtoSubServices\DataAnalytics\dataanalytics.scss", "SCSS", 0, 0, 0, 8, 0, 0, 8
"c:\Users\ketan\colon33\src\components\SubtoSubServices\DataModelling\DataModelling.jsx", "JavaScript JSX", 0, 0, 60, 0, 1, 6, 67
"c:\Users\ketan\colon33\src\components\SubtoSubServices\DataModelling\datamodelling.scss", "SCSS", 0, 0, 0, 8, 0, 0, 8
"c:\Users\ketan\colon33\src\components\SubtoSubServices\DataVisualization\DataVisualization.jsx", "JavaScript JSX", 0, 0, 48, 0, 1, 5, 54
"c:\Users\ketan\colon33\src\components\SubtoSubServices\DataVisualization\datavisualization.scss", "SCSS", 0, 0, 0, 8, 0, 0, 8
"c:\Users\ketan\colon33\src\components\SubtoSubServices\Devops\Devops.jsx", "JavaScript JSX", 0, 0, 72, 0, 1, 5, 78
"c:\Users\ketan\colon33\src\components\SubtoSubServices\Devops\devops.scss", "SCSS", 0, 0, 0, 8, 0, 0, 8
"c:\Users\ketan\colon33\src\components\SubtoSubServices\DigitalIdentity\DigitalIdentity.jsx", "JavaScript JSX", 0, 0, 84, 0, 1, 5, 90
"c:\Users\ketan\colon33\src\components\SubtoSubServices\DigitalIdentity\digitalidentity.scss", "SCSS", 0, 0, 0, 8, 0, 0, 8
"c:\Users\ketan\colon33\src\components\SubtoSubServices\DigitalTwin\DigitalTwin.jsx", "JavaScript JSX", 0, 0, 60, 0, 1, 5, 66
"c:\Users\ketan\colon33\src\components\SubtoSubServices\DigitalTwin\digitaltwin.scss", "SCSS", 0, 0, 0, 8, 0, 0, 8
"c:\Users\ketan\colon33\src\components\SubtoSubServices\GovtRisk\GovtRisk.jsx", "JavaScript JSX", 0, 0, 48, 0, 1, 5, 54
"c:\Users\ketan\colon33\src\components\SubtoSubServices\GovtRisk\govtrisk.scss", "SCSS", 0, 0, 0, 8, 0, 0, 8
"c:\Users\ketan\colon33\src\components\SubtoSubServices\HybridCloud\HybridCloud.jsx", "JavaScript JSX", 0, 0, 36, 0, 1, 5, 42
"c:\Users\ketan\colon33\src\components\SubtoSubServices\HybridCloud\hybridcloud.scss", "SCSS", 0, 0, 0, 8, 0, 0, 8
"c:\Users\ketan\colon33\src\components\SubtoSubServices\IAM\IAM.jsx", "JavaScript JSX", 0, 0, 72, 0, 1, 6, 79
"c:\Users\ketan\colon33\src\components\SubtoSubServices\IAM\iam.scss", "SCSS", 0, 0, 0, 8, 0, 0, 8
"c:\Users\ketan\colon33\src\components\SubtoSubServices\IOT\iot.jsx", "JavaScript JSX", 0, 0, 84, 0, 1, 5, 90
"c:\Users\ketan\colon33\src\components\SubtoSubServices\IOT\iot.scss", "SCSS", 0, 0, 0, 8, 0, 0, 8
"c:\Users\ketan\colon33\src\components\SubtoSubServices\IPA\IPA.jsx", "JavaScript JSX", 0, 0, 84, 0, 1, 5, 90
"c:\Users\ketan\colon33\src\components\SubtoSubServices\IPA\ipa.scss", "SCSS", 0, 0, 0, 8, 0, 0, 8
"c:\Users\ketan\colon33\src\components\SubtoSubServices\LegacyModernization\Legacy.jsx", "JavaScript JSX", 0, 0, 84, 0, 1, 5, 90
"c:\Users\ketan\colon33\src\components\SubtoSubServices\LegacyModernization\legacy.scss", "SCSS", 0, 0, 0, 8, 0, 0, 8
"c:\Users\ketan\colon33\src\components\SubtoSubServices\LowCode\Lodecode.jsx", "JavaScript JSX", 0, 0, 72, 0, 1, 6, 79
"c:\Users\ketan\colon33\src\components\SubtoSubServices\LowCode\lowcode.scss", "SCSS", 0, 0, 0, 8, 0, 0, 8
"c:\Users\ketan\colon33\src\components\SubtoSubServices\MachineLearning\MachineLearning.jsx", "JavaScript JSX", 0, 0, 72, 0, 1, 6, 79
"c:\Users\ketan\colon33\src\components\SubtoSubServices\MachineLearning\machinelearning.scss", "SCSS", 0, 0, 0, 8, 0, 0, 8
"c:\Users\ketan\colon33\src\components\SubtoSubServices\MobileApp\AppDevelopment.jsx", "JavaScript JSX", 0, 0, 72, 0, 1, 6, 79
"c:\Users\ketan\colon33\src\components\SubtoSubServices\MobileApp\appdev.scss", "SCSS", 0, 0, 0, 8, 0, 0, 8
"c:\Users\ketan\colon33\src\components\SubtoSubServices\NextGenSupport\NextGenSupport.jsx", "JavaScript JSX", 0, 0, 48, 0, 1, 5, 54
"c:\Users\ketan\colon33\src\components\SubtoSubServices\NextGenSupport\nextgensupport.scss", "SCSS", 0, 0, 0, 8, 0, 0, 8
"c:\Users\ketan\colon33\src\components\SubtoSubServices\Oracle\Oracle.jsx", "JavaScript JSX", 0, 0, 36, 0, 1, 5, 42
"c:\Users\ketan\colon33\src\components\SubtoSubServices\Oracle\oracle.scss", "SCSS", 0, 0, 0, 8, 0, 0, 8
"c:\Users\ketan\colon33\src\components\SubtoSubServices\ProductEngg\ProductEngg.jsx", "JavaScript JSX", 0, 0, 84, 0, 1, 5, 90
"c:\Users\ketan\colon33\src\components\SubtoSubServices\ProductEngg\productengg.scss", "SCSS", 0, 0, 0, 8, 0, 4, 12
"c:\Users\ketan\colon33\src\components\SubtoSubServices\QualityAssurance\QualityAssurance.jsx", "JavaScript JSX", 0, 0, 72, 0, 1, 6, 79
"c:\Users\ketan\colon33\src\components\SubtoSubServices\QualityAssurance\qualityassurance.scss", "SCSS", 0, 0, 0, 8, 0, 0, 8
"c:\Users\ketan\colon33\src\components\SubtoSubServices\SAP\Sap.jsx", "JavaScript JSX", 0, 0, 36, 0, 1, 5, 42
"c:\Users\ketan\colon33\src\components\SubtoSubServices\SAP\sap.scss", "SCSS", 0, 0, 0, 8, 0, 0, 8
"c:\Users\ketan\colon33\src\components\SubtoSubServices\SalesForce\SalesForce.jsx", "JavaScript JSX", 0, 0, 36, 0, 1, 5, 42
"c:\Users\ketan\colon33\src\components\SubtoSubServices\SalesForce\salesforce.scss", "SCSS", 0, 0, 0, 8, 0, 0, 8
"c:\Users\ketan\colon33\src\components\SubtoSubServices\ServiceNow\ServiceNow.jsx", "JavaScript JSX", 0, 0, 36, 0, 1, 5, 42
"c:\Users\ketan\colon33\src\components\SubtoSubServices\ServiceNow\servicenow.scss", "SCSS", 0, 0, 0, 8, 0, 0, 8
"c:\Users\ketan\colon33\src\components\SubtoSubServices\Workplace\Workplace.jsx", "JavaScript JSX", 0, 0, 60, 0, 1, 6, 67
"c:\Users\ketan\colon33\src\components\SubtoSubServices\Workplace\workplace.scss", "SCSS", 0, 0, 0, 8, 0, 0, 8
"c:\Users\ketan\colon33\src\components\common\DropdownMenu\DropdownServices.js", "JavaScript", 3, 0, 0, 0, 0, 0, 3
"c:\Users\ketan\colon33\src\components\common\DropdownMenu\DropdownServices1.js", "JavaScript", 105, 0, 0, 0, 0, 1, 106
"c:\Users\ketan\colon33\src\components\common\Navbar\Navbar.jsx", "JavaScript JSX", 0, 0, -5, 0, 5, 0, 0
"c:\Users\ketan\colon33\src\components\common\SubServicesCommon\SubServicesCommon.jsx", "JavaScript JSX", 0, 0, 4, 0, 0, 0, 4
"c:\Users\ketan\colon33\src\components\common\SubServicesCommon\SubServicesDesc\SubServicesDesc.jsx", "JavaScript JSX", 0, 0, 0, 0, -56, -1, -57
"c:\Users\ketan\colon33\src\components\common\SubtoSubServicesCommon\SubtoSubServicesCommon.jsx", "JavaScript JSX", 0, 0, 27, 0, 72, 4, 103
"c:\Users\ketan\colon33\src\components\common\SubtoSubServicesCommon\SubtoSubServicesDesc\SubtoSubServicesDesc.jsx", "JavaScript JSX", 0, 0, 49, 0, 4, 19, 72
"c:\Users\ketan\colon33\src\components\common\SubtoSubServicesCommon\SubtoSubServicesDesc\subtosubservicesdesc.scss", "SCSS", 0, 0, 0, 123, 17, 26, 166
"c:\Users\ketan\colon33\src\components\common\SubtoSubServicesCommon\subtosubservices.scss", "SCSS", 0, 0, 0, 6, 0, 0, 6
"c:\Users\ketan\colon33\src\components\common\casestudy\CaseStudy.jsx", "JavaScript JSX", 0, 0, 23, 0, 1, 2, 26
"c:\Users\ketan\colon33\src\components\common\casestudy\casestudy.scss", "SCSS", 0, 0, 0, 79, 2, 14, 95
"c:\Users\ketan\colon33\src\components\common\connectwithus\Connectwithus.jsx", "JavaScript JSX", 0, 0, 16, 0, 0, 2, 18
"c:\Users\ketan\colon33\src\components\common\connectwithus\connectwithus.scss", "SCSS", 0, 0, 0, 25, 1, 3, 29
"c:\Users\ketan\colon33\src\components\dummySlider\DummySlider.jsx", "JavaScript JSX", 0, 0, 117, 0, 14, 8, 139
"c:\Users\ketan\colon33\src\components\dummySlider\dummys.scss", "SCSS", 0, 0, 0, 7, 0, 0, 7
"c:\Users\ketan\colon33\src\index.css", "CSS", 0, 0, 0, 0, 1, 0, 1
"Total", "-", 179, 0, 2536, 518, 91, 278, 3602